Everything Everything - Mountainhead
Hot Water Music - Vows
Alkaline Trio - Blood, Hair, and Eyeballs
Fontaines D.C. - Romance
St. Vincent - All Born Screaming
Touché Amoré - Spiral in a Straight Line
London Grammar - The Greatest Love
Wunderhorse - Midas
Bad Nerves - Still Nervous
Many Eyes - The Light Age
Chuck Ragan - Love & Lore
Slomosa - Tundra Rock
Jerry Cantrell - I Want Blood
Sløtface - Film Buff
The Cure - Songs Of A Lost World
El Cuero - ... are we done yet?
Kendrick Lamar - GNX
IDLES - TANGK
Linkin Park - From Zero
Better Lovers - Highly Irresponsible
Myles Kennedy - The Art of Letting Go
Blood Incantation - Absolute Elsewhere
Mannequin Pussy - I Got Heaven
Knocked Loose - You Won't Go Before You're Supposed To
SPRINTS - Letter To Self
Chat Pile - Cool World
Drug Church - PRUDE
Deadletter - Hysterical Strength
Japandroids - Fate & Alcohol
High Vis - Guided Tour
Neck Deep - Neck Deep
Supermilk - High Precision Ghosts
Greenleaf - The Head & The Habit
The Last Dinner Party - Prelude to Ecstasy
Whores - War.
FIDLAR - Surviving The DreamFather John Misty
Father John Misty - Mahashmashana
Michael Kiwanuka - Small Changes
Los Campesinos! - All Hell
The Decemberists - As It Ever Was, So It Will Be Again
